M100000001
0100000001
0111110001
0000010001
0001110001
0000000001
0001000001
0001111101
001H000001
1111111111

