111111
1H0001
101101
101101
100M01
111111