111111111
1001M0001
101101001
100000001
101111001
100001101
11000H011
100100001
111111111