111111111111
100011001001
101H00001101
100111111101
110011101001
111010110001
100000000101
110100110101
100100010011
110011111001
10001M000001
111111111111